"a" = (/turf/closed/wall/r_wall/coastwall,/area/ground)
"b" = (/turf/open/floor/holofloor/beach/coast_b,/area/ground)
"c" = (/turf/open/floor/holofloor/beach,/area/ground)
"d" = (/turf/open/floor/grass,/area/ground)
"e" = (/obj/effect/landmark/start{name = "Scientist"},/turf/open/floor/grass,/area/ground)
"f" = (/obj/effect/landmark/start{name = "Atmospheric Technician"},/turf/open/floor/grass,/area/ground)
"g" = (/obj/effect/landmark/start{name = "Assistant"},/turf/open/floor/grass,/area/ground)
"h" = (/obj/effect/landmark/start{name = "Head of Security"},/turf/open/floor/grass,/area/ground)
"i" = (/obj/effect/landmark/start{name = "Station Engineer"},/turf/open/floor/grass,/area/ground)
"j" = (/obj/effect/landmark/start{name = "Security Officer"},/turf/open/floor/grass,/area/ground)
"k" = (/obj/effect/landmark/start{name = "Captain"},/turf/open/floor/grass,/area/ground)
"l" = (/obj/effect/landmark/start{name = "Bartender"},/turf/open/floor/grass,/area/ground)
"m" = (/obj/effect/landmark/start{name = "Detective"},/turf/open/floor/grass,/area/ground)
"n" = (/obj/effect/landmark/start{name = "Botanist"},/turf/open/floor/grass,/area/ground)
"o" = (/obj/effect/landmark/start{name = "Chaplain"},/turf/open/floor/grass,/area/ground)
"p" = (/obj/effect/landmark/start{name = "Cargo Technician"},/turf/open/floor/grass,/area/ground)
"q" = (/obj/effect/landmark/start{name = "Head of Personnel"},/turf/open/floor/grass,/area/ground)

(1,1,1) = {"
aaaaaaaaaaaaaaaaaaaaaaaaaaaaaaaaaaaaaaaaaaaaaaaaaaaaaaaaaaaaaaaaaaaaaaaaaaaaaaaaaaaaa
abbbbbbbbbbbbbbbbbbbbbbbbbbbbbbbbbbbbbbbbbbbbbbbbbbbbbbbbbbbbbbbbbbbbbbbbbbbbbbbbbbba
abbbbbbbbbbbbbbbbbbbbbbbbbbbbbbbbbbbbbbbbbbbbbbbbbbbbbbbbbbbbbbbbbbbbbbbbbbbbbbbbbbba
abbbbbbbbbbbbbbbbbbbbbbbbbbbbbbbbbbbbbbbbbbbbbbbbbbbbbbbbbbbbbbbbbbbbbbbbbbbbbbbbbbba
abbbbbbbbbbbbbbbbbbbbbbbbbbbbbbbbbbbbbbbbbbbbbbbbbbbbbbbbbbbbbbbbbbbbbbbbbbbbbbbbbbba
abbbbbbbbbbbbbbbbbbbbbbbbbbbbbbbbbbbbbbbbbbbbbbbbbbbbbbbbbbbbbbbbbbbbbbbbbbbbbbbbbbba
abbbbbbbbbbbbbbbbbbbbbbbbbbbbbbbbbbbbbbbbbbbbbbbbbbbbbbbbbbbbbbbbbbbbbbbbbbbbbbbbbbba
abbbbbbbbbbbbbbbbbbbbbbbbbbbbbbbbbbbbbbbbbbbbbbbbbbbbbbbbbbbbbbbbbbbbbbbbbbbbbbbbbbba
abbbbbbbbbbbbbbbbbbbbbbbbbbbbbbbbbbbbbbbbbbbbbbbbbbbbbbbbbbbbbbbbbbbbbbbbbbbbbbbbbbba
abbbbbbbbbbbbbbbbbbbbbbbbbbbbbbbbbbbbbbbbbbbbbbbbbbbbbbbbbbbbbbbbbbbbbbbbbbbbbbbbbbba
abbbbbbbbbbbbbbbbbbbbbbbbbbbbbbbbbbbbbbbbbbbbbbbbbbbbbbbbbbbbbbbbbbbbbbbbbbbbbbbbbbba
abbbbbccccccccccccccccccccccccccccccccccccccccccccccccccccccccccccccccccccccccbbbbbba
abbbbbccccccccccccccccccccccccccccccccccccccccccccccccccccccccccccccccccccccccbbbbbba
abbbbbccddddddddddddddddddddddddddddddddddddddddddddddddddddddddddddddddddddccbbbbbba
abbbbbccddddddddddddddddddddddddddddddddddddddddddddddddddddddddddddddddddddccbbbbbba
abbbbbccddddddddddddddddddddddddddddddddddddddddddddddddddddddddddddddddddddccbbbbbba
abbbbbccddddddddddddddddddddddddddddddddddddddddddddddddddddddddddddddddddddccbbbbbba
abbbbbccddddddddddddddddddddddddddddddddddddddddddddddddddddddddddddddddddddccbbbbbba
abbbbbccddddddddddddddddddddddddddddddddddddddddddddddddddddddddddddddddddddccbbbbbba
abbbbbccddddddddddddddddddddddddddddddddddddddddddddddddddddddddddddddddddddccbbbbbba
abbbbbccddddddddddddddddddddddddddddddddddddddddddddddddddddddddddddddddddddccbbbbbba
abbbbbccddddddddddddddddddddddddddddddddddddddddddddddddddddddddddddddddddddccbbbbbba
abbbbbccddddddddddddddddddddddddddddddddddddddddddddddddddddddddddddddddddddccbbbbbba
abbbbbccddddddddddddddddddddddddddddddddddddddddddddddddddddddddddddddddddddccbbbbbba
abbbbbccddddddddddddddddddddddddddddddddddddddddddddddddddddddddddddddddddddccbbbbbba
abbbbbccddddddddddddddddddddddddddddddddddddddddddddddddddddddddddddddddddddccbbbbbba
abbbbbccddddddddddddddddddddddddddddddddddddddddddddddddddddddddddddddddddddccbbbbbba
abbbbbccddddddddddddddddddddddddddddddddddddddddddddddddddddddddddddddddddddccbbbbbba
abbbbbccddddddddddddddddddddddddddddddddddddddddddddddddddddddddddddddddddddccbbbbbba
abbbbbccddddddddddddddddddddddddddddddddddddddddddddddddddddddddddddddddddddccbbbbbba
abbbbbccddddddddddddddddddddddddddddddddddddddddddddddddddddddddddddddddddddccbbbbbba
abbbbbccddddddddddddddddddddddddddddddddddddddddddddddddddddddddddddddddddddccbbbbbba
abbbbbccddddddddddddddddddddddddddddddddddddddddddddddddddddddddddddddddddddccbbbbbba
abbbbbccddddddddddddddddddddddddddddddddddddddddddddddddddddddddddddddddddddccbbbbbba
abbbbbccddddddddddddddddddddddddddddddddddddddddddddddddddddddddddddddddddddccbbbbbba
abbbbbccddddddddddddddddddddddddddddddddddddddddddddddddddddddddddddddddddddccbbbbbba
abbbbbccddddddddddddddddddddddddddddddddddddddddddddddddddddddddddddddddddddccbbbbbba
abbbbbccddddddddddddddddddddddddddddddddddddddddddddddddddddddddddddddddddddccbbbbbba
abbbbbccddddddddddddddddddddddddddddddddddddddddddddddddddddddddddddddddddddccbbbbbba
abbbbbccddddddddddddddddddddddddddddddddddddddddddddddddddddddddddddddddddddccbbbbbba
abbbbbccddddddddddddddddddddddddddddddddddddddddddddddddddddddddddddddddddddccbbbbbba
abbbbbccddddddddddddddddddddddddddddddddddddddddddddddddddddddddddddddddddddccbbbbbba
abbbbbccddddddddddddddddddddddddddddddddddddddddddddddddddddddddddddddddddddccbbbbbba
abbbbbccddddddddddddddddddddddddddddddddddddddddddddddddddddddddddddddddddddccbbbbbba
abbbbbccddddddddddddddddddddddddddddddddddddddddddddddddddddddddddddddddddddccbbbbbba
abbbbbccddddddddddddddddddddddddddddddddddddddddddddddddddddddddddddddddddddccbbbbbba
abbbbbccddddddddddddddddddddddddddddddddddddddddddddddddddddddddddddddddddddccbbbbbba
abbbbbccddddddddddddddddddddddddddddddddddddddddddddddddddddddddddddddddddddccbbbbbba
abbbbbccddddddddddddddddddddddddddddddddddddddddddddddddddddddddddddddddddddccbbbbbba
abbbbbccddddddddddddddddddddddddddddddddddddddddddddddddddddddddddddddddddddccbbbbbba
abbbbbccddddddddddddddddddddddddddddddddddddddddddddddddddddddddddddddddddddccbbbbbba
abbbbbccddddddddddddddddddddddddddddddddddddddddddddddddddddddddddddddddddddccbbbbbba
abbbbbccddddddddddddddddddddddddddddddddddddddddddddddddddddddddddddddddddddccbbbbbba
abbbbbccddddddddddddddddddddddddddddddddddddddddddddddddddddddddddddddddddddccbbbbbba
abbbbbccdddddddddddddddddddddddddddddddeddddddddddddddddddddddddddddddddddddccbbbbbba
abbbbbccddddddddddddddddddddddddddddddddddddddddddddddddddddddddddddddddddddccbbbbbba
abbbbbccddddddddddddddddddddddddddddddfddddddgddddddddddddddddddddddddddddddccbbbbbba
abbbbbccdddddddddddddddddddddddddddddddddhddddddddddddddddddddddddddddddddddccbbbbbba
abbbbbccddddddddddddddddddddddddddddddddddddidddddddddddddddddddddddddddddddccbbbbbba
abbbbbccddddddddddddddddddddddddddddjdddddddddddddddddddddddddddddddddddddddccbbbbbba
abbbbbccddddddddddddddddddddddddddddddddgddddkddddddddddddddddddddddddddddddccbbbbbba
abbbbbccddddddddddddddddddddddddddddddddddddddddddddddddddddddddddddddddddddccbbbbbba
abbbbbccdddddddddddddddddddddddddddddlddddddddddddddddddddddddddddddddddddddccbbbbbba
abbbbbccdddddddddddddddddddddddddddddddddddddddmddddddddddddddddddddddddddddccbbbbbba
abbbbbccdddddddddddddddddddddddddddddddddddnddddddddodddddddddddddddddddddddccbbbbbba
abbbbbccddddddddddddddddddddddddddddddddddddddddddddddddddddddddddddddddddddccbbbbbba
abbbbbccdddddddddddddddddddddddddddddddpddddddddddddddddddddddddddddddddddddccbbbbbba
abbbbbccddddddddddddddddddddddddddddddddddddddqdddddddddddddddddddddddddddddccbbbbbba
abbbbbccddddddddddddddddddddddddddddddddddddddddddddddddddddddddddddddddddddccbbbbbba
abbbbbccddddddddddddddddddddddddddddddddddddddddddddddddddddddddddddddddddddccbbbbbba
abbbbbccddddddddddddddddddddddddddddddddddddddddddddddddddddddddddddddddddddccbbbbbba
abbbbbccddddddddddddddddddddddddddddddddddddddddddddddddddddddddddddddddddddccbbbbbba
abbbbbccddddddddddddddddddddddddddddddddddddddddddddddddddddddddddddddddddddccbbbbbba
abbbbbccddddddddddddddddddddddddddddddddddddddddddddddddddddddddddddddddddddccbbbbbba
abbbbbccddddddddddddddddddddddddddddddddddddddddddddddddddddddddddddddddddddccbbbbbba
abbbbbccddddddddddddddddddddddddddddddddddddddddddddddddddddddddddddddddddddccbbbbbba
abbbbbccddddddddddddddddddddddddddddddddddddddddddddddddddddddddddddddddddddccbbbbbba
abbbbbccccccccccccccccccccccccccccccccccccccccccccccccccccccccccccccccccccccccbbbbbba
abbbbbccccccccccccccccccccccccccccccccccccccccccccccccccccccccccccccccccccccccbbbbbba
abbbbbbbbbbbbbbbbbbbbbbbbbbbbbbbbbbbbbbbbbbbbbbbbbbbbbbbbbbbbbbbbbbbbbbbbbbbbbbbbbbba
abbbbbbbbbbbbbbbbbbbbbbbbbbbbbbbbbbbbbbbbbbbbbbbbbbbbbbbbbbbbbbbbbbbbbbbbbbbbbbbbbbba
abbbbbbbbbbbbbbbbbbbbbbbbbbbbbbbbbbbbbbbbbbbbbbbbbbbbbbbbbbbbbbbbbbbbbbbbbbbbbbbbbbba
abbbbbbbbbbbbbbbbbbbbbbbbbbbbbbbbbbbbbbbbbbbbbbbbbbbbbbbbbbbbbbbbbbbbbbbbbbbbbbbbbbba
abbbbbbbbbbbbbbbbbbbbbbbbbbbbbbbbbbbbbbbbbbbbbbbbbbbbbbbbbbbbbbbbbbbbbbbbbbbbbbbbbbba
aaaaaaaaaaaaaaaaaaaaaaaaaaaaaaaaaaaaaaaaaaaaaaaaaaaaaaaaaaaaaaaaaaaaaaaaaaaaaaaaaaaaa
"}
